             *       *       *       * 
 ******* *** * * *** * ***** ***** * * 
 *     *   * * *   *   *   * *     * * 
 * * ***** * ***** ***** * * * ***** * 
 * *     * *     * *   * *   * *E  *   
 * ***** * ***** * *** * ***** *** *** 
 * *   * * *   *   *   *   *   *     * 
 * * * * * * * ***** ***** * *** ***** 
 * * *   * * *   *           * *     * 
 *** *** * * *** * *********** * *** * 
   *   * * * *   * * *   *     * * *   
** *** *** * * *** * * * *** *** * ****
 *   * *   * *     * * *   *     *   * 
 *** * * ***** ***** * *** * ***** * * 
   * * *     *       *   * *       *   
** * * ***** *********** * ******* ****
   *   *     *   *       *   *     *   
 ***** * ***** * * ********* * ***** * 
       *       *   *S  *   * * *     * 
 ********************* * * * *** ***** 
   *           *     *   * *   * *     
** *********** * *** ***** * * * * ****
 * *         * * * *     * * *   *     
 * * ******* * * * *** * * * ********* 
 * * * *     *   *   * * * *   *     * 
 * * * * ***** ***** * * * *** * *** * 
   * *   *   * *     * * * *   * * *   
 *** * ***** * *** *** * * ***** * ****
   * *     *     *   * * *   *   *     
** * ***** ***** * * * * *** * *** * **
 *   *   *     * * * * *   * * *   *   
 ***** * ***** * *** * *** * * * ***** 
     * *     * *     *   * *   *     * 
** * *** *** * ********* * ******* *** 
   *     *   * *         * *       *   
 *********** * * ********* ********* * 
   *   *   * * *   *   *   *   *   * * 
 * * * * * *** *** * * * *** * * * * * 
 *   *   *         * *       *   *   * 
